2ax=Berserker's Hatchet (Set Double Axe)
6cs=Naj's Puzzler (Set Elder Staff)
7gd=Bul-Kathos' Sacred Charge (Set Colossus Blade)
7ls=Sazabi's Cobalt Redeemer (Set Cryptic Sword)
7m7=Immortal King's Stone Crusher (Set Ogre Maul)
7ma=Dangoon's Teaching (Set Reinforced Mace)
7qr=Natalya's Mark (Set Scissors Suwayyah)
7wd=Bul-Kathos' Tribal Guardian (Set Mythical Sword)
7ws=Griswolds's Redemption (Set Caduceus)
9mt=Aldur's Rhythm (Set Jagged Star)
9vo=Hwanin's Justice (Set Bill)
aar=Milabrega's Robe (Set Ancient Armor)
amc=M'avina's Caster (Set Grand Matron Bow)
amu=Set Amulet
ba5=Immortal King's Will (Set Avenger Guard)
bhm=Tancred's Skull (Set Bone Helm)
brs=Isenhart's Case (Set Breast Plate)
bsd=Isenhart's Lightbrand (Set Broad Sword)
bst=Cathan's Rule (Set Battle Staff)
buc=Hsarus' Iron Fist (Set Buckler)
bwn=Sander's Superstition (Set Bone Wand)
cap=Infernal Cranium or Sander's Paragon (Set Cap)
chn=Cathan's Mesh (Set Chain Mail)
ci0=Naj's Circlet (Set Circlet)
ci3=M'avina's True Sight (Set Diadem)
crn=Iratha's Coil or Milabrega's Diadem (Set Crown)
dr8=Aldur's Stony Gaze (Set Hunter's Guise)
fhl=Isenhart's Horns (Set Full Helm)
ful=Tancred's Spine (Set Full Plate Mail)
ghm=Sigon's Visor (Set Great Helm)
gsc=Civerb's Cudgel (Set Grand Scepter)
gth=Sigon's Shelter (Set Gothic Plate)
gts=Isenhart's Parry (Set Gothic Shield)
gwn=Infernal Torch (Set Grim Wand)
hbl=Sigon's Wrap (Set Plated Belt)
hbt=Sigon's Sabot (Set Greaves)
hgl=Sigon's Gage (Set Gauntlets)
hlm=Berserker's Headgear (Set Helm)
kit=Milabrega's Orb (Set Kite Shield)
lbb=Vidala's Barb (Set Long Battle Bow)
lbl=Death's Guard (Set Sash)
lbt=Tancred's Hobnails (Set Boots)
lea=Vidala's Ambush (Set Leather Armor)
lgl=Death's Hand (Set Leather Gloves)
lrg=Civerb's Ward (Set Large Shield)
lsd=Cleglaw's Tooth (Set Long Sword)
ltp=Arcanna's Flesh (Set Light Plate)
mbl=Hsarus' Iron Stay or Hwanin's Blessing (Set Belt)
mbt=Hsarus' Iron Heel (Set Chain Boots)
mgl=Cleglaw's Pincers (Set Chain Gloves)
mpi=Tancred's Crowbill (Set Military Pick)
msk=Cathan's Visage (Set Mask)
ne9=Trang-Oul's Wing (Set Cantor Trophy)
oba=Tal Rasha's Lidless Eye (Set Swirling Crystal)
paf=Griswold's Honor (Set Vortex Shield)
qui=Arctic Furs (Set Quilted Armor)
rin=Set Ring
rng=Angelic Mantle (Set Ring Mail)
sbr=Angelic Sickle (Set Saber)
skp=Arcanna's Head (Set Skull Cap)
sml=Cleglaw's Claw (Set Small Shield)
spl=Berserker's Hauberk (Set Splint Mail)
stu=Cow King's Hide (Set Studded Leather)
swb=Arctic Horn (Set Short War Bow)
tbl=Infernal Sign or Iratha's Cord (Set Heavy Belt)
tbt=Vidala's Fetlock (Set Light Plated Boots)
tgl=Arctic Mitts or Iratha's Cuff (Set Light Gauntlets)
tow=Sigon's Guard (Set Tower Shield)
uar=Immortal King's Soul Cage (Set Sacred Armor)
ucl=Natalya's Shadow (Set Loricated Mail)
uh9=Trang-Oul's Guise (Set Bone Visage)
uhm=Ondal's Almighty (Set Spired Helm)
uld=M'avina's Embrace (Set Kraken Shell)
ulg=Laying of Hands (Set Bramble Mitts)
ult=Naj's Light Plate (Set Hellforge Plate)
umc=Credendum (Set Mithril Coil)
upl=Sazabi's Ghost Liberator (Set Balrog Skin)
urn=Griswold's Valor (Set Corona)
utc=Trang-Oul's Girth (Set Troll Belt)
uth=Tal Rasha's Guardianship (Set Lacquered Plate)
uts=Taebaek's Glory (Set Ward)
uui=Dark Adherent (Set Dusk Shroud)
uul=Aldur's Deception (Set Shadow Plate)
vbl=Arctic Binding (Set Light Belt)
vbt=Cow King's Hooves or Sander's Riprap (Set Heavy Boots)
vgl=Sander's Taboo (Set Heavy Gloves)
wsd=Death's Touch (Set War Sword)
wsp=Milabrega's Rod (Set War Scepter)
wst=Arcanna's Deathwand (Set War Staff)
xap=Cow King's Horns (Set War Hat)
xar=Griswold's Heart (Set Ornate Plate)
xcl=Hwanin's Refuge (Set Tigulated Mail)
xh9=Natalya's Totem (Set Grim Helm)
xhb=Immortal King's Pillar (Set War Boots)
xhg=Immortal King's Forge (Set War Gauntlets)
xhl=Sazabi's Mental Sheath (Set Basinet)
xhm=Guillaume's Face (Set Winged Helm)
xlb=Rite of Passage (Set Demonhide Boots)
xmb=Natalya's Soul (Set Mesh Boots)
xmg=Trang-Oul's Claws (Set Heavy Bracers)
xml=Whitstan's Guard (Set Round Shield)
xrn=Hwanin's Splendor (Set Grand Crown)
xrs=Haemosu's Adament (Set Cuirass)
xsk=Tal Rasha's Horadric Crest (Set Death Mask)
xtb=Aldur's Advance (Set Battle Boots)
xtg=M'avina's Icy Clutch (Set Battle Gauntlets)
xul=Trang-Oul's Scales (Set Chaos Armor)
xvg=Magnus' Skin (Set Sharkskin Gloves)
zhb=Immortal King's Detail (Set War Belt)
zmb=Tal Rasha's Fine-spun Cloth (Set Mesh Belt)
ztb=Wilhelm's Pride (Set Battle Belt)
zvb=M'avina's Tenet (Set Sharkskin Belt)