2ax=Bladebone (Unique Double Axe)
2hs=Shadowfang (Unique Two-Handed Sword)
6cs=Ondal's Wisdom (Unique Elder Staff)
6hx=Hellrack (Unique Colossus Crossbow)
6l7=Eaglehorn (Unique Crusader Bow)
6lw=Windforce (Unique Hydra Bow)
6sw=Widowmaker (Unique Ward Bow)
6sx=Gutsiphon (Unique Demon Crossbow)
6ws=Mang Song's Lesson (Unique Archon Staff)
72a=Runemaster (Unique Ettin Axe)
7b7=Doombringer (Unique Champion Sword)
7b8=Lacerator (Unique Winged Axe)
7ba=Ethereal Edge (Unique Silver-Edged Axe)
7bk=Warshrike (Unique Winged Knife)
7bl=Ghostflame (Unique Legend Spike)
7br=Viperfork (Unique Mancatcher)
7bt=Hellslayer (Unique Decapitator)
7bw=Boneshade (Unique Lich Wand)
7cl=Nord's Tenderizer (Unique Truncheon)
7cr=Lightsabre or Azurewrath (Unique Phase Blade)
7cs=Shadowkiller (Unique Battle Cestus)
7dg=Wizardspike (Unique Bone Knife)
7fl=Horizon's Tornado or Stormlash (Unique Scourge)
7ga=Messerschmidt's Reaver (Unique Champion Axe)
7gd=The Grandfather (Unique Colossus Blade)
7gi=Executioner's Justice (Unique Glorious Axe)
7gl=Wraithflight (Unique Ghost Glaive)
7gm=The Cranium Basher or Earthshifter (Unique Thunder Maul)
7gs=Flamebellow (Unique Balrog Blade)
7gw=Death's Web (Unique Unearthed Wand)
7ha=Razoredge (Unique Tomahawk)
7kr=Fleshripper (Unique Fanged Knife)
7ls=Frostwind (Unique Cryptic Sword)
7lw=Firelizard's Talons (Unique Feral Claws)
7m7=Windhammer (Unique Ogre Maul)
7mp=Cranebeak (Unique War Spike)
7mt=Baranar's Star (Unique Devil Star)
7o7=Bonehew (Unique Ogre Axe)
7p7=Steelpillar (Unique War Pike)
7pa=Tomb Reaver (Unique Cryptic Axe)
7s7=Demon's Arch (Unique Balrog Spear)
7s8=The Reaper's Toll (Unique Thresher)
7sb=Bloodmoon (Unique Elegant Blade)
7sc=Heaven's Light or The Reedeemer (Unique Mighty Scepter)
7sm=Djinn Slayer (Unique Ataghan)
7sp=Demonlimb (Unique Tyrant Club)
7sr=Arioc's Needle (Unique Hyperion Spear)
7ta=Gimmershred (Unique Flying Axe)
7ts=Gargoyle's Bite (Unique Winged Harpoon)
7wa=Deathcleaver (Unique Berserker Axe)
7wb=Jade Talon (Unique Wrist Sword)
7wc=Stormspire (Unique Giant Thresher)
7wh=Schaefer's Hammer or Stone Crusher (Unique Legendary Mallet)
7ws=Ironward (Unique Caduceus)
8bs=Warpspear (Unique Gothic Staff)
8cb=Endlesshail (Unique Double Bow)
8cs=Chromatic Ire (Unique Cedar Staff)
8hb=Riphook (Unique Razor Bow)
8hx=Buriza-Do Kyanon (Unique Ballista)
8l8=Cliffkiller (Unique Large Siege Bow)
8lb=Kuko Shakaku (Unique Cedar Bow)
8ls=Ribcracker (Unique Quarterstaff)
8lw=Goldstrike Arch (Unique Gothic Bow)
8lx=Langer Briser (Unique Arbalest)
8mx=Pus Spitter (Unique Siege Crossbow)
8rx=Demon Machine (Unique Chu-Ko-Nu)
8s8=Witchwild String (Unique Short Siege Bow)
8sb=Skystrike (Unique Edge Bow)
8ss=Razorswitch (Unique Jo Staff)
8sw=Magewrath (Unique Rune Bow)
8ws=Skull Collector (Unique Rune Staff)
92a=Islestrike (Unique Twin Axe)
92h=Crainte vomir (Unique Espandon)
9ax=Butcher's Pupil (Unique Cleaver)
9b7=The Meat Scraper (Unique Lochaber Axe)
9b9=Cloudcrack (Unique Gothic Sword)
9ba=Spellsteel (Unique Bearded Axe)
9bl=Stormspike (Unique Stiletto)
9br=Soulfeast Tine (Unique War Fork)
9bs=Headstriker (Unique Battle Sword)
9bt=Stormrider (Unique Tabar)
9bw=Arm Of King Leoric (Unique Tomb Wand)
9cl=Dark Clan Crusher (Unique Cudgel)
9cm=Bing Sz Wang (Unique Dacian Falx)
9cr=Ginther's Rift (Unique Dimensional Blade)
9dg=Spineripper (Unique Poignard)
9di=Heart Carver (Unique Rondel)
9fb=Todesfaelle Flamme (Unique Zweihander)
9fc=Blade of Ali Baba (Unique Tulwar)
9fl=Baezil's Vortex (Unique Knout)
9ga=Boneslayer Blade (Unique Gothic Axe)
9gd=Swordguard (Unique Executioner Sword)
9gi=The Minotaur (Unique Ancient Axe)
9gm=The Gavel Of Pain (Unique Martel de Fer)
9gs=The Vile Husk (Unique Tusk Sword)
9gw=Blackhand Key (Unique Grave Wand)
9h9=Husoldal Evo (Unique Bec-De-Corbin)
9ha=Coldkill (Unique Hatchet)
9kr=Blackbog's Sharp (Unique Cinquedeas)
9la=Warlord's Trust (Unique Military Axe)
9ls=Plague Bearer (Unique Rune Sword)
9m9=Bloodtree Stump (Unique War Club)
9ma=Sureshrill Frost (Unique Flanged Mace)
9mp=Pompeii's Wrath (Unique Crowbill)
9mt=Moonfall (Unique Jagged Star)
9p9=Spire of Honor (Unique Lance)
9pa=Pierre Tombale Couant (Unique Partizan)
9qs=The Fetid Sprinkler (Unique Holy Water Sprinkler)
9s8=Athena's Wrath (Unique Battle Scythe)
9sb=Hexfire (Unique Shamshir)
9sc=Zakarum's Hand (Unique Rune Scepter)
9sm=Coldsteel Eye (Unique Cutlass)
9sp=Fleshrender (Unique Barbed Club)
9sr=The Impaler (Unique War Spear)
9ss=Bloodletter (Unique Gladius)
9st=Hone Sundan (Unique Yari)
9ta=The Scalper (Unique Francisca)
9tk=Deathbit (Unique Battle Dart)
9tr=Kelpie Snare (Unique Fuscina)
9tw=Bartuc's Cut-Throat (Unique Greater Talons)
9vo=Blackleach Blade (Unique Bill)
9wa=Guardian Naga (Unique Naga)
9wc=Grim's Burning Dead (Unique Grim Scythe)
9wd=The Atlantean (Unique Ancient Sword)
9wh=Earthshaker (Unique Battle Hammer)
9wn=Suicide Branch (Unique Burnt Wand)
9ws=Hand of Blessed Light (Unique Divine Scepter)
9yw=Carin Shard (Unique Petrified Wand)
aar=Silks of the Victor (Unique Ancient Armor)
am7=Lycander's Aim (Unique Ceremonial Bow)
am9=Lycander's Flank (Unique Ceremonial Pike)
ama=Titan's Revenge (Unique Ceremonial Javelin)
amb=Bloodraven's Charge (Unique Matriarchal Bow)
amd=Stoneraven (Unique Matriarchal Spear)
amf=Thunderstroke (Unique Matriarchal Javelin)
amu=Unique Amulet
axe=Deathspade (Unique Axe)
baa=Arreat's Face (Unique Slayer Guard)
bac=Wolfhowl (Unique Fury Helm)
bad=Demonhorn's Edge (Unique Destroyer Helm)
bae=Halaberd's Reign (Unique Conqueror Crown)
bar=Dimoak's Hew (Unique Bardiche)
bax=Goreshovel (Unique Broad Axe)
bhm=Wormskull (Unique Bone Helm)
bld=Spectral Shard (Unique Blade)
brn=Bloodthief (Unique Brandistock)
brs=Venom Ward (Unique Breast Plate)
bsd=Griswold's Edge (Unique Broad Sword)
bsh=Wall of the Eyeless (Unique Bone Shield)
bst=The Salamander (Unique Battle Staff)
bsw=Blacktongue (Unique Bastard Sword)
btx=The Chieftain (Unique Battle Axe)
buc=Pelta Lunata (Unique Buckler)
bwn=Gravenspine (Bone Wand)
cap=Biggin's Bonnet (Unique Cap)
cbw=Rogue's Bow (Unique Composite Bow)
chn=Sparking Mail (Unique Chain Mail)
ci2=Kira's Guardian (Unique Tiara)
ci3=Griffon's Eye (Unique Diadem)
clb=Felloak (Unique Club)
clm=Soulflay (Unique Claymore)
cm1=Annihilus (Unique Small Charm)
cm3=Gheed's Fortune (Unique Grand Charm)
crn=Undead Crown (Unique Crown)
crs=Azurewrath (Unique Crystal Sword)
cst=Spire of Lazarus (Unique Gnarled Staff)
dgr=Gull (Unique Dagger)
dir=Diggler (Unique Dirk)
dra=Jalal's Mane (Unique Totemic Mask)
drb=Cerebus (Unique Blood Spirit)
drd=Spiritkeeper (Unique Earth Spirit)
dre=Ravenlore (Unique Sky Spirit)
fhl=Duskdeep (Unique Full Helm)
fla=The General's Tan Do Li Ga (Unique Flail)
flb=Ripsaw (Unique Flamberge)
flc=Gleamscythe (Unique Falchion)
fld=Rockfleece (Unique Field Plate)
ful=Goldskin (Unique Full Plate Mail)
gax=Brainhew (Unique Great Axe)
ghm=Howltusk (Unique Great Helm)
gis=Kinemil's Awl (Unique Giant Sword)
gix=The Humongous (Unique Giant Axe)
gma=Steeldriver (Unique Great Maul)
gsc=Rusthandle (Unique Grand Scepter)
gsd=The Patriarch (Unique Great Sword)
gth=Rattlecage (Unique Gothic Plate)
gts=The Ward (Unique Gothic Shield)
gwn=Ume's Lament (Unique Grim Wand)
hal=Woestave (Unique Halberd)
hax=The Gnasher (Unique Hand Axe)
hbl=Bladebuckle (Unique Plated Belt)
hbt=Tearhaunch (Unique Greaves)
hbw=Witherstring (Unique Hunter's Bow)
hgl=Frostburn (Unique Gauntlets)
hla=The Centurion (Unique Hard Leather Armor)
hlm=Coif of Glory (Unique Helm)
hxb=Hellcast (Unique Heavy Crossbow)
jew=Rainbow Facet (Unique Jewel)
kit=Steelclash (Unique Kite Shield)
kri=The Jade Tan Do (Unique Kris)
lax=Axe of Fechmar (Unique Large Axe)
lbb=Wizendraw (Unique Long Battle Bow)
lbl=Lenymo (Unique Sash)
lbt=Hotspur (Unique Boots)
lbw=Raven Claw (Unique Long Bow)
lea=Blinkbat's Form (Unique Leather Armor)
lgl=The Hand of Broc (Unique Leather Gloves)
lrg=Stormguild (Unique Large Shield)
lsd=Hellplague (Unique Long Sword)
lst=Serpent Lord (Unique Long Staff)
ltp=Heavenly Garb (Unique Light Plate)
lwb=Blastbark (Unique Long War Bow)
lxb=Leadcrow (Unique Light Crossbow)
mac=Crushflange (Unique Mace)
mau=Bonesnap (Unique Maul)
mbl=Nightsmoke (Unique Belt)
mbt=Treads of Cthon (Unique Chain Boots)
mgl=Chance Guards (Unique Chain Gloves)
mpi=Skull Splitter (Unique Military Pick)
msk=The Face of Horror (Unique Mask)
mst=Bloodrise (Unique Morning Star)
mxb=Ichorsting (Unique Crossbow)
nea=Homunculus (Unique Hierophant Trophy)
nee=Boneflame (Unique Succubae Skull)
nef=Darkforge Spawn (Unique Bloodlord Skull)
oba=The Oculus (Unique Swirling Crystal)
obc=Eschuta's Temper (Unique Eldritch Orb)
obf=Death's Fathom (Unique Dimensional Shard)
pa9=Herald of Zakarum (Unique Gilded Shield)
pac=Alma Negra (Unique Sacred Rondache)
pae=Dragonscale (Unique Zakarum Shield)
pax=The Battlebranch (Unique Poleaxe)
pik=The Tannr Gorerod (Unique Pike)
plt=Boneflesh (Unique Plate Mail)
qui=Greyform (Unique Quilted Armor)
rin=Unique Ring
rng=Darkglow (Unique Ring Mail)
rxb=Doomslinger (Unique Repeating Crossbow)
sbb=Stormstrike (Unique Short Battle Bow)
sbr=Skewer of Krintiz (Unique Saber)
sbw=Pluckeye (Unique Short Bow)
scl=Hawkmail (Unique Scale Mail)
scm=Blood Crescent (Unique Scimitar)
scp=Knell Striker (Unique Scepter)
scy=Soul Harvest (Unique Scythe)
skp=Tarnhelm (Unique Skull Cap)
sml=Umbral Disk (Unique Small Shield)
spc=Stoutnail (Unique Spiked Club)
spk=Swordback Hold (Unique Spiked Shield)
spl=Iceblink (Unique Splint Mail)
spr=The Dragon Chang (Unique Spear)
spt=Lance of Yaggai (Unique Spetum)
ssd=Rixot's Keen (Unique Short Sword)
sst=Bane Ash (Unique Short staff)
stu=Twitchthroe (Unique Studded Leather)
swb=Hellclap (Unique Short War Bow)
tbl=Goldwrap (Unique Heavy Belt)
tbt=Goblin Toe (Unique Light Plated Boots)
tgl=Magefist (Unique Light Gauntlets)
tow=Bverrit Keep (Unique Tower Shield)
tri=Razortine (Unique Trident)
uap=Harlequin Crest (Unique Shako)
uar=Tyrael's Might or Templar's Might (Unique Sacred Armor)
uh9=Giantskull (Unique Bone Visage)
uhb=Shadowdancer (Unique Myrmidon Greaves)
uhm=Veil of Steel or Nightwing's Veil (Unique Spired Helm)
uhg=Steelrend (Unique Ogre Gauntlets)
uit=Stormshield (Unique Monarch)
ulc=Arachnid Mesh (Unique Spiderweb Sash)
uld=Leviathan (Unique Kraken Shell)
ulm=Steelshade (Unique Armet)
umb=Marrowwalk (Unique Boneweave Boots)
umc=Verdugo's Hearty Cord (Unique Mithril Coil)
umg=Souldrainer (Unique Vambraces)
uml=Blackoak Shield (Unique Luna)
uow=Medusa's Gaze (Unique Aegis)
upk=Spike Thorn (Unique Blade Barrier)
upl=Arkaine's Valor (Unique Balrog Skin)
ush=Headhunter's Glory (Unique Troll Nest)
usk=Andariel's Visage (Unique Demonhead)
uts=Spirit Ward (Unique Ward)
utu=The Gladiator's Bane (Unique Wire Fleece)
uui=Ormus' Robes (Unique Dusk Shroud)
uul=Steel Carapace (Unique Shadow Plate)
uvb=Sandstorm Trek (Unique Scarabshell Boots)
uvc=Nosferatu's Coil (Unique Vampirefang Belt)
uvg=Dracul's Grasp (Unique Vampirebone Gloves)
vbl=Snakecord (Unique Light Belt)
vbt=Gorefoot (Unique Heavy Boots)
vgl=Bloodfist (Unique Heavy Gloves)
vou=Steelgoad (Unique Voulge)
wax=Rakescar (Unique War Axe)
whm=Ironstone (Unique War Hammer)
wnd=Torch of Iro (Unique Wand)
wsc=The Grim Reaper (Unique War Scythe)
wsd=Culwen's Point (Unique war Sword)
wsp=Stormeye (Unique War Scepter)
wst=The Iron Jang Bong (Unique War Staff)
xap=Peasant Crown (Unique War Hat)
xar=Corpsemourn (Unique Ornate Plate)
xcl=Crow Caw (Unique Tigulated Mail)
xea=Skin of the Vipermagi (Unique Serpentskin Armor)
xh9=Vampiregaze (Unique Grim Helm)
xhb=Gore Rider (Unique War Boots)
xhg=Hellmouth (Unique War Gauntlets)
xhl=Darksight Helm (Unique Basinet)
xhm=Valkyrie Wing (Unique Winged Helm)
xhn=Shaftstop (Unique Mesh Armor)
xit=Tiamat's Rebuke (Unique Dragon Shield)
xkp=Rockstopper (Unique Sallet)
xla=Skin of the Flayed One (Unique Demonhide Armor)
xlb=Infernostride (Unique Demonhide Boots)
xld=Toothrow (Unique Sharktooth Armor)
xlg=Venom Grip (Unique Demonhide Gloves)
xlm=Stealskull (Unique Casque)
xlt=Guardian Angel (Unique Templar Coat)
xmb=Silkweave (Unique Mesh Boots)
xmg=Ghoulhide (Unique Heavy Bracers)
xml=Moser's Blessed Circle (Unique Round Shield)
xng=Spirit Forge (Unique Linked Mail)
xow=Gerke's Sanctuary (Unique Pavise)
xpk=Lance Guard (Unique Barbed Shield)
xpl=Skullder's Ire (Unique Russet Armor)
xrg=Stormchaser (Unique Scutum)
xrn=Crown of Thieves (Unique Grand Crown)
xrs=Duriel's Shell (Unique Cuirass)
xsh=Lidless Wall (Unique Grim Shield)
xsk=Blackhorn's Face (Unique Death Mask)
xtb=War Traveler (Unique Battle Boots)
xtg=Lava Gout (Unique Battle Gauntlets)
xth=Atma's Wail (Unique Embossed Plate)
xtp=Que-Hegan's Wisdom (Unique Mage Plate)
xts=Radament's Sphere (Unique Ancient Shield)
xtu=Iron Pelt (Unique Trellised Armor)
xuc=Visceratuant (Unique Defender)
xui=The Spirit Shroud (Unique Ghost Armor)
xul=Black Hades (Unique Chaos Armor)
xvb=Waterwalk (Unique Sharkskin Boots)
xvg=Gravepalm (Unique Sharkskin Gloves)
ywn=Maelstrom (Unique Yew Wand)
zhb=Thundergod's Vigor (Unique War Belt)
zlb=String of Ears (Unique Demonhide Sash)
zmb=Gloom's Trap (Unique Mesh Belt)
ztb=Snowclash (Unique Battle Belt)
zvb=Razortail (Unique Sharkskin Belt)